XXXXXXXXXXXXXXXXXXXXXXXXXXXXXXXXXXXXXXXXXXXXXXXXXXXXXXXXXXXXXXXX
X1232523211231123252132521eXXXXXXXXXXXXXXXXXXXXXXXXXXXXXXXXXXXXX
X123223222223322XXXXXXXXXXXXXXXXXXXXXXXXXXXXXXXXXXXXXXXXXXXXXXXX
X123312321322232XXXXXXXXXXXXXXXXXXXXXXXXXXXXXXXXXXXXXXXXXXXXXXXX
X213212321232232XXXXXXXXXXXXXXXXXXXXXXXXXXXXXXXXXXXXXXXXXXXXXXXX
X123212321322321XXXXXXXXXXXXXXXXXXXXXXXXXXXXXXXXXXXXXXXXXXXXXXXX
X213123123221322XXXXXXXXXXXXXXXXXXXXXXXXXXXXXXXXXXXXXXXXXXXXXXXX
X123221223232231221322a2322231222353221322321223132323322321231X
X12322132213223122213223231221312321232223222222123232331231212X
X12312123121212321321121212323212312313123132131323232131313213X
X1231221231231231232312121232d132132131323213123213213213231312X
XXXXXXXXXXXXXXXXXXXXXXXXXXXXXXXX2132132321313123213123213123213X
XXXXXXXXXXXXXXXXXXXXXXXXXXXXXXXX3132131212312312321312312321321X
XXXXXXXXXXXXXXXXXXXXXXXXXXXXXXXX12313132132131232131232132132c3X
XXXXXXXXXXXXXXXXXXXXXXXXXXXXXXXX3123123213213213132312321321312X
XXXXXXXXXXXbXXXXXXXXXXXXXXXXXXXX3123213212223321323213213213213X
XXXXXXXXXXXXXXXXXXXXXXXXXXXXXXXX1123122213231231313213123123123X
XXXXXXXXXXXXXXXXXXXXXXXXXXXXXXXXXXXXXXXXXXXXXXXXXXXXXXXXXXXXXXXX