XXXXXXXXXXXXXXXXXXXXXX
X32123212111123211112X
X2212222111X122211b21X
X1232232111X111111111X
X1XXXXXXXXXXXXXX11211X
X12111X2111XXXXX11233X
X1X112X1*11XXXXX12112X
XXX21XX*111X111111211X
X2X212*XXXXX111111111X
X2221*1X121X1122122c2X
X11**12X1d2X122313233X
XXXXXXXXXXXXXXXXXXXXXX

